h	A	
D	B	
O	C	
t	D	
w	E	
L	F	
J	G	
N	H	
b	I	
a	J	
c	K	
v	L	
V	M	
C	N	
G	O	
T	P	
F	Q	
W	R	
B	S	
K	T	
f	U	
S	V	
k	W	
X	X	
R	Y	
p	a	
i	b	
I	c	
o	d	
g	e	
U	f	
P	g	
q	h	
d	i	
x	j	
m	k	
H	l	
r	m	
M	n	
e	o	
A	p	
Y	q	
E	r	
u	s	
s	t	
l	u	
y	v	
n	w	
Q	x	
j	y	
