A	h	
B	D	
C	O	
D	t	
E	w	
F	L	
G	J	
H	N	
I	b	
J	a	
K	c	
L	v	
M	V	
N	C	
O	G	
P	T	
Q	F	
R	W	
S	B	
T	K	
U	f	
V	S	
W	k	
X	X	
Y	R	
a	p	
b	i	
c	I	
d	o	
e	g	
f	U	
g	P	
h	q	
i	d	
j	x	
k	m	
l	H	
m	r	
n	M	
o	e	
p	A	
q	Y	
r	E	
s	u	
t	s	
u	l	
v	y	
w	n	
x	Q	
y	j	
